1, 1, 1, 1, 1, 1, 1, 1, 1, 1
1, 1, 201, 201, 201, 201, 201, 201, 1, 1
1, 201, 101, 101, 202, 101, 202, 202, 201, 1
1, 101, 202, 202, 202, 202, 202, 202, 101, 1
1, 202, 202, 101, 202, 101, 202, 101, 202, 1
1, 101, 202, 202, 202, 101, 101, 202, 101, 1
1, 202, 101, 101, 202, 202, 101, 202, 202, 1
1, 101, 202, 202, 202, 101, 101, 202, 101, 1
1, 202, 101, 202, 101, 202, 202, 101, 202, 1
1, 101, 202, 101, 101, 202, 101, 101, 202, 1
